22224322111013111131011122342222
21122240111300111100311104222112
11222362211354411445311226322211
11310311113442211224431111301311
21134700306401322310460300743112
22434004224812211221842240043422
12203031122203111130222113030221
22200011222247111174222211000222
11013540316233122133261304531011
11224830112221622612221103842211
33122006411001322310011460022133
07222223311234200243211332222270
01112222112248011084221122221110
11461222131220022002213122216411
12111342162222222222226124311121
22211403311222122122211330411222
22211403311222122122211330411222
12111342162222222222226124311121
11461222131220022002213122216411
01112222112248011084221122221110
07222223311234200243211332222270
33122006411001322310011460022133
11224830112221622612221103842211
11013540316233122133261304531011
22200011222247111174222211000222
12203031122203111130222113030221
22434004224812211221842240043422
21134700306401322310460300743112
11310311113442211224431111301311
11222362211354411445311226322211
21122240111300111100311104222112
22224322111013111131011122342222
